8 8 8 8 8 8 7 8 8 8 8 8 8 8 7 8 8 8 8 8 7 8 8 8 8 8 8 7 8 8
8 7 8 8 8 8 8 8 8 8 8 8 8 8 8 4 4 4 4 4 4 4 4 4 4 4 8 8 8 7
8 8 8 8 8 8 8 8 8 8 7 8 8 8 8 4 8 7 8 8 9 9 7 8 8 4 8 8 9 8
8 8 8 7 8 8 8 8 8 8 8 9 8 8 8 4 8 8 8 8 9 8 8 8 7 4 8 8 7 8
8 8 8 8 8 8 8 8 8 8 8 8 8 7 8 4 9 8 8 8 7 8 8 8 8 4 7 8 8 8
7 8 8 8 8 8 9 7 8 8 8 8 8 8 2 4 4 4 4 4 4 4 8 8 8 4 8 8 8 8
8 8 8 8 8 8 8 8 8 8 8 8 8 2 2 2 2 2 5 5 5 4 8 7 8 4 8 8 8 8
8 8 8 8 8 4 4 4 4 4 4 8 7 2 2 2 2 2 2 5 5 4 8 8 8 4 8 9 7 8
8 5 7 8 8 4 2 2 2 8 4 8 8 8 2 2 2 2 2 2 7 4 8 5 8 4 8 7 8 8
5 5 8 8 8 4 2 2 8 8 4 8 8 4 4 4 4 4 8 8 8 4 5 5 8 4 8 8 8 8
5 5 5 8 7 4 2 2 8 8 4 8 8 4 8 8 8 4 7 8 8 4 5 5 5 4 8 8 8 7
4 4 4 4 4 4 2 8 7 8 4 4 4 4 2 8 8 4 8 8 8 4 5 5 5 4 8 7 8 8
5 5 8 8 8 8 7 8 8 8 5 5 2 2 2 2 8 4 8 8 8 4 5 8 8 4 8 8 8 8
5 5 5 8 8 8 8 8 5 5 5 5 8 2 2 8 8 4 8 8 9 4 7 8 8 4 8 8 8 8
5 9 8 8 8 8 8 8 5 5 5 5 5 8 8 7 8 4 4 4 4 4 8 9 8 4 8 8 7 8
5 8 8 7 8 8 8 7 8 8 8 8 8 8 8 8 8 8 8 8 8 7 8 8 8 4 7 8 8 9
8 8 8 8 9 8 8 8 8 8 7 8 8 8 8 8 9 7 8 8 8 8 8 8 8 4 4 4 4 4
7 8 8 8 8 7 8 8 8 8 8 8 8 7 8 8 8 8 8 8 8 8 8 7 8 8 7 8 8 8